{
   "auto_collapse" : 5,
   "bg_color" : [ 0.78431399999999996, 0.78431399999999996, 0.78431399999999996 ],
   "body" : [
      [ 0, 0, 0, 0, 0, 0, 0, 0 ],
      [ 0, 0, 0, 0, 0, 0, 0, 0 ],
      [ 0, 0, 0, 0, 0, 0, 0, 0 ],
      [ 0, 0, 0, 0, 0, 0, 0, 0 ],
      [ 0, 0, -1, 0, 0, -1, 0, 0 ],
      [ 0, 0, -1, 0, 0, -1, 0, 0 ],
      [ 0, 0, -1, 0, 0, -1, 0, 0 ],
      [ 0, 0, -1, 0, 0, -1, 0, 0 ],
      [ 0, 0, -1, 0, 0, -1, 0, 0 ],
      [ 0, 0, -1, 0, 0, -1, 0, 0 ],
      [ 0, 0, -1, 0, 0, -1, 0, 0 ],
      [ 0, 0, 0, 0, 0, 0, 0, 0 ],
      [ 0, 0, 0, 0, 0, 0, 0, 0 ],
      [ 0, 0, 0, 0, 0, 0, 0, 0 ],
      [ 0, 0, 0, 0, 0, 0, 0, 0 ],
      [ 0, -1, 0, -1, -1, 0, -1, 0 ],
      [ 0, -1, 0, -1, -1, 0, -1, 0 ],
      [ 0, -1, 0, -1, -1, 0, -1, 0 ],
      [ 0, -1, 0, -1, -1, 0, -1, 0 ],
      [ 0, -1, 0, -1, -1, 0, -1, 0 ],
      [ 0, -1, 0, -1, -1, 0, -1, 0 ],
      [ 0, -1, 0, -1, -1, 0, -1, 0 ],
      [ 0, 0, 0, 0, 0, 0, 0, 0 ],
      [ 0, 0, 0, 0, 0, 0, 0, 0 ],
      [ 0, 0, 0, 0, 0, 0, 0, 0 ],
      [ 0, 0, -1, 0, 0, -1, 0, 0 ],
      [ 0, 0, -1, 0, 0, -1, 0, 0 ],
      [ 0, 0, -1, 0, 0, -1, 0, 0 ],
      [ 0, 0, -1, 0, 0, -1, 0, 0 ],
      [ 0, 0, -1, 0, 0, -1, 0, 0 ],
      [ 0, 0, -1, 0, 0, -1, 0, 0 ],
      [ 0, 0, -1, 0, 0, -1, 0, 0 ],
      [ 0, 0, 0, 0, 0, 0, 0, 0 ],
      [ 0, 0, 0, 0, 0, 0, 0, 0 ],
      [ 0, -1, 0, -1, -1, 0, -1, 0 ],
      [ 0, -1, 0, -1, -1, 0, -1, 0 ],
      [ 0, -1, 0, -1, -1, 0, -1, 0 ],
      [ 0, -1, 0, -1, -1, 0, -1, 0 ],
      [ 0, -1, 0, -1, -1, 0, -1, 0 ],
      [ 0, -1, 0, -1, -1, 0, -1, 0 ],
      [ 0, -1, 0, -1, -1, 0, -1, 0 ],
      [ 0, 0, 0, 0, 0, 0, 0, 0 ],
      [ 0, 0, 0, 0, 0, 0, 0, 0 ],
      [ 1, 0, -1, 0, 0, -1, 0, 1 ],
      [ 1, 0, -1, 0, 0, -1, 0, 1 ],
      [ 1, 0, -1, 0, 0, -1, 0, 1 ],
      [ 1, 0, -1, 0, 0, -1, 0, 1 ],
      [ 1, 0, -1, 0, 0, -1, 0, 1 ],
      [ 1, 0, -1, 0, 0, -1, 0, 1 ],
      [ 1, 0, -1, 0, 0, -1, 0, 1 ],
      [ 0, 0, 0, 0, 0, 0, 0, 0 ],
      [ 0, 0, 0, 0, 0, 0, 0, 0 ],
      [ 0, 0, 0, 0, 0, 0, 0, 0 ],
      [ 0, -1, 0, 1, 1, 0, -1, 0 ],
      [ 0, -1, 0, 1, 1, 0, -1, 0 ],
      [ 0, -1, 0, 1, 1, 0, -1, 0 ],
      [ 0, -1, 0, 1, 1, 0, -1, 0 ],
      [ 0, -1, 0, 1, 1, 0, -1, 0 ],
      [ 0, -1, 0, 1, 1, 0, -1, 0 ],
      [ 0, -1, 0, 1, 1, 0, -1, 0 ],
      [ 0, 0, 0, 0, 0, 0, 0, 0 ],
      [ 0, 0, 0, 0, 0, 0, 0, 0 ],
      [ 0, 0, 0, 0, 0, 0, 0, 0 ],
      [ 0, 0, -1, 0, 0, -1, 0, 0 ],
      [ 0, 0, -1, 0, 0, -1, 0, 0 ],
      [ 0, -1, -1, 0, 0, -1, -1, 0 ],
      [ 0, 0, 0, 0, 0, 0, 0, 0 ],
      [ 0, 0, 0, 0, 0, 0, 0, 0 ],
      [ -1, 0, 0, -1, -1, 0, 0, -1 ],
      [ -1, 0, 0, -1, -1, 0, 0, -1 ],
      [ -1, 0, 0, -1, -1, 0, 0, -1 ],
      [ 0, 0, 0, 0, 0, 0, 0, 0 ],
      [ 0, 0, 0, 0, 0, 0, 0, 0 ],
      [ 0, 0, 0, 0, 0, 0, 0, 0 ],
      [ 0, -1, 0, 0, 0, 0, -1, 0 ],
      [ 0, -1, 0, 0, 0, 0, -1, 0 ],
      [ 0, 0, 0, 0, 0, 0, 0, 0 ],
      [ 0, 0, 0, -1, -1, 0, 0, 0 ],
      [ 0, 0, 0, -1, -1, 0, 0, 0 ],
      [ 0, 0, 0, 0, 0, 0, 0, 0 ],
      [ 0, -1, -1, 0, 0, -1, -1, 0 ],
      [ 0, 0, -1, 0, 0, -1, 0, 0 ],
      [ 0, 0, -1, 0, 0, -1, 0, 0 ],
      [ 0, 0, 0, 0, 0, 0, 0, 0 ],
      [ 0, 0, 0, 0, 0, 0, 0, 0 ],
      [ 0, 0, 0, 0, 0, 0, 0, 0 ],
      [ 0, 0, 0, -1, -1, 0, 0, 0 ],
      [ 0, 0, 0, 0, 0, 0, 0, 0 ],
      [ 0, 0, 0, 1, 1, 0, 0, 0 ],
      [ 0, 0, 0, 0, 0, 0, 0, 0 ],
      [ 0, 0, 0, 0, 0, 0, 0, 0 ],
      [ 0, 0, 0, 0, 0, 0, 0, 0 ],
      [ 0, 0, 0, 0, 0, 0, 0, 0 ],
      [ 0, 0, 0, 0, 0, 0, 0, 0 ],
      [ 0, 0, 0, 0, 0, 0, 0, 0 ],
      [ 0, 0, 0, 0, 0, 0, 0, 0 ],
      [ 0, 0, 0, 0, 0, 0, 0, 0 ],
      [ 0, 0, 0, 0, 0, 0, 0, 0 ],
      [ 0, 0, 0, 0, 0, 0, 0, 0 ],
      [ 0, 0, 0, 0, 0, 0, 0, 0 ]
   ],
   "build_speed" : 0.55000001192092896,
   "camera" : "reverse",
   "collapse_speed" : 0.55500000715255737,
   "color" : [ 0.25097999999999998, 0.25097999999999998, 0.25097999999999998 ],
   "falling" : [
      {
         "delay" : 0,
         "entry" : [ 0, 0, 97 ],
         "interval" : 0.25
      },
      {
         "delay" : 0,
         "entry" : [ 3, 0, 97 ],
         "interval" : 0.29999999999999999
      },
      {
         "delay" : 0,
         "entry" : [ 4, 0, 97 ],
         "interval" : 0.29999999999999999
      },
      {
         "delay" : 0,
         "entry" : [ 7, 0, 97 ],
         "interval" : 0.25
      }
   ],
   "items" : [
      [ 2, 0, 23 ],
      [ 5, 0, 23 ],
      [ 1, 0, 64 ],
      [ 6, 0, 64 ],
      [ 1, 0, 81 ],
      [ 6, 0, 81 ],
      [ 2, 0, 91 ],
      [ 5, 0, 91 ]
   ],
   "light_tween" : "default",
   "moving" : [
      {
         "entry" : [ 3, 0, 95 ],
         "pattern" : [ 6, 6, 6, 0, 4, 4, 4, 0 ]
      },
      {
         "entry" : [ 4, 0, 95 ],
         "pattern" : [ 4, 4, 4, 0, 6, 6, 6, 0 ]
      }
   ],
   "oneways" : [
      {
         "direction" : "up",
         "position" : [ 0, 0, 92 ],
         "power" : 5
      },
      {
         "direction" : "up",
         "position" : [ 7, 0, 92 ],
         "power" : 5
      }
   ],
   "pickable" : 0,
   "x_offset" : 0
}
