{
   "auto_collapse" : 6.5,
   "bg_color" : [ 0.62745099999999998, 0.62745099999999998, 0.62745099999999998 ],
   "body" : [
      [ 0, 0, 0, 0, 0, 0, 0, 0 ],
      [ 0, 0, 0, 0, 0, 0, 0, 0 ],
      [ -1, -1, 0, 0, 0, 0, -1, -1 ],
      [ -1, -1, 0, 0, 0, 0, -1, -1 ],
      [ -1, -1, -1, 0, 0, -1, -1, -1 ],
      [ -1, -1, -1, 0, 0, -1, -1, -1 ],
      [ -1, -1, -1, 0, 0, -1, -1, -1 ],
      [ -1, -1, -1, 0, 0, -1, -1, -1 ],
      [ -1, -1, -1, 0, 0, -1, -1, -1 ],
      [ -1, -1, -1, 0, 0, -1, -1, -1 ],
      [ -1, -1, 0, 0, 0, 0, -1, -1 ],
      [ -1, 0, 0, 0, 0, 0, 0, -1 ],
      [ -1, 0, 0, 0, 0, 0, 0, -1 ],
      [ 0, 0, 0, 0, 0, 0, 0, 0 ],
      [ 0, 0, 0, 0, 0, 0, 0, 0 ],
      [ 0, 0, 0, 0, 0, 0, 0, 0 ],
      [ 0, 0, 0, 0, 0, 0, 0, 0 ],
      [ -1, 0, 0, 0, 0, 0, 0, -1 ],
      [ -1, 0, 0, 0, 0, 0, 0, -1 ],
      [ -1, 0, 0, -1, -1, -1, -1, -1 ],
      [ -1, 0, 0, -1, -1, -1, -1, -1 ],
      [ -1, 0, 0, -1, -1, -1, -1, -1 ],
      [ -1, 0, 0, -1, -1, -1, -1, -1 ],
      [ -1, 0, 0, -1, -1, -1, -1, -1 ],
      [ -1, 0, 0, -1, -1, -1, -1, -1 ],
      [ -1, 0, 0, -1, -1, -1, -1, -1 ],
      [ -1, 0, 0, -1, -1, 0, 0, -1 ],
      [ 0, 0, 0, 0, 0, 0, 0, 0 ],
      [ 0, 0, 0, 0, 0, 0, 0, 0 ],
      [ 0, 0, 0, 0, 0, 0, 0, 0 ]
   ],
   "build_speed" : 0.55000001192092896,
   "camera" : "normal",
   "collapse_speed" : 0.80000001192092896,
   "color" : [ 0.39215699999999998, 0.68627499999999997, 0.92941200000000002 ],
   "items" : [
      [ 3, 0, 6 ],
      [ 3, 0, 9 ],
      [ 4, 0, 13 ],
      [ 4, 0, 16 ],
      [ 1, 0, 22 ],
      [ 2, 0, 26 ],
      [ 5, 0, 26 ],
      [ 6, 0, 26 ]
   ],
   "light_tween" : "default",
   "pickable" : 0,
   "x_offset" : 0
}
