{
  "body":
  [
    [ 0, 0, 0, 0, 0, 0, 0, 0 ],
    [ 0, 0, 0, 0, 0, 0, 0, 0 ],
    [ 0, 0, 0,-1,-1, 0, 0, 0 ],
    [ 0, 0, 0,-1,-1, 0, 0, 0 ],
    [ 0, 0, 0, 0, 0, 0, 0, 0 ],
    [ 0, 1, 1, 0, 0, 1, 1, 0 ],
    [ 0, 1, 1, 0, 0, 1, 1, 0 ],
    [ 0, 0, 0, 0, 0, 0, 0, 0 ],
    [ 0, 0, 0, 0, 0, 0, 0, 0 ],
    [ 0, 0, 0, 0, 0, 0, 0, 0 ],

    [ 0, 0, 0, 0, 0, 0, 0, 0 ],
    [ 0, 0, 0, 0, 0, 0, 0, 0 ],
    [ 0, 0, 0, 0, 0, 0, 0, 0 ],
    [ 0, 0, 0, 0, 0, 0, 0, 0 ],
    [ 0, 0, 0,-1,-1, 0, 0, 0 ],
    [ 0, 0, 0,-1,-1, 0, 0, 0 ],
    [ 0, 0, 0,-1,-1, 0, 0, 0 ],
    [ 0, 0, 0,-1,-1, 0, 0, 0 ],
    [ 0, 0, 0, 0, 0, 0, 0, 0 ],
    [ 0, 0, 0, 0, 0, 0, 0, 0 ]
  ],
  
  "build_speed": 0.8,
  "collapse_speed": 0.8,
  "auto_collapse": 9,

  "color": [ 116, 0.22, 0.8 ],
  "bg_color": [ 0, 0, 0.7 ],

  "pickable": 1
}
