{
   "auto_collapse" : 6,
   "bg_color" : [ 0.62745099999999998, 0.62745099999999998, 0.62745099999999998 ],
   "body" : [
      [ -1, -1, 0, 0, 0, 0, -1, -1 ],
      [ -1, -1, 0, 0, 0, 0, -1, -1 ],
      [ -1, -1, 0, 0, 0, 0, -1, -1 ],
      [ -1, -1, 0, 0, 0, 0, -1, -1 ],
      [ -1, -1, 0, 0, 0, 0, -1, -1 ],
      [ -1, -1, 0, 0, 0, 0, 0, 0 ],
      [ -1, -1, 0, 0, 0, 0, 0, 0 ],
      [ -1, -1, 0, 0, 0, 0, 0, 0 ],
      [ -1, -1, -1, -1, -1, 0, 0, 0 ],
      [ -1, -1, -1, -1, -1, 0, 0, 0 ],
      [ -1, -1, -1, -1, -1, 0, 0, 0 ],
      [ -1, -1, -1, -1, -1, 0, 0, 0 ],
      [ -1, -1, -1, -1, -1, 0, 0, 0 ],
      [ -1, -1, -1, -1, -1, 0, 0, 0 ],
      [ -1, -1, -1, -1, -1, 0, 0, 0 ],
      [ -1, -1, 0, 0, 0, 0, 0, 0 ],
      [ -1, -1, 0, 0, 0, 0, 0, 0 ],
      [ -1, -1, 0, 0, 0, 0, 0, 0 ],
      [ -1, -1, 0, 0, 0, -1, -1, -1 ],
      [ -1, -1, 0, 0, 0, -1, -1, -1 ],
      [ -1, -1, 0, 0, 0, -1, -1, -1 ],
      [ -1, -1, 0, 0, 0, -1, -1, -1 ],
      [ 0, 0, 0, 0, 0, -1, -1, -1 ],
      [ 0, 0, 0, 0, 0, -1, -1, -1 ],
      [ 0, 0, 0, 0, 0, -1, -1, -1 ],
      [ 0, 0, 0, -1, -1, -1, -1, -1 ],
      [ 0, 0, 0, -1, -1, -1, -1, -1 ],
      [ 0, 0, 0, -1, -1, -1, -1, -1 ],
      [ 0, 0, 0, -1, -1, -1, -1, -1 ],
      [ 0, 0, 0, 0, 0, 0, -1, -1 ],
      [ 0, 0, 0, 0, 0, 0, -1, -1 ],
      [ 0, 0, 0, 0, 0, 0, -1, -1 ],
      [ -1, -1, -1, -1, 0, 0, -1, -1 ],
      [ 0, 0, 0, 0, 0, 0, -1, -1 ],
      [ 0, 0, 0, 0, 0, 0, -1, -1 ],
      [ 0, 0, 0, 0, 0, 0, -1, -1 ],
      [ 0, 0, -1, -1, 0, 0, -1, -1 ],
      [ 0, 0, -1, -1, 0, 0, -1, -1 ],
      [ 0, 0, -1, -1, 0, 0, -1, -1 ],
      [ 0, 0, -1, -1, 0, 0, -1, -1 ]
   ],
   "build_speed" : 0.49000000953674316,
   "camera" : "normal",
   "collapse_speed" : 0.55000001192092896,
   "color" : [ 0.57254899999999997, 0.027451, 0.51372600000000002 ],
   "falling" : [
      {
         "delay" : 0,
         "entry" : [ 3, 0, 22 ],
         "interval" : 0.5
      },
      {
         "delay" : 0,
         "entry" : [ 1, 0, 25 ],
         "interval" : 0.40000000000000002
      },
      {
         "delay" : 0,
         "entry" : [ 5, 0, 35 ],
         "interval" : 0.40000000000000002
      }
   ],
   "items" : [
      [ 3, 0, 4 ],
      [ 6, 0, 6 ],
      [ 6, 0, 12 ],
      [ 3, 0, 20 ],
      [ 1, 0, 30 ],
      [ 5, 0, 30 ],
      [ 1, 0, 37 ],
      [ 5, 0, 37 ]
   ],
   "light_tween" : "default",
   "moving" : [
      {
         "entry" : [ 4, 0, 16 ],
         "pattern" : [ 2, 0, 8, 0, 8, 0, 2, 0 ]
      },
      {
         "entry" : [ 2, 0, 34 ],
         "pattern" : [ 2, 0, 8, 0 ]
      }
   ],
   "pickable" : 0,
   "x_offset" : 0
}
