{
   "stage" : {
      "auto_collapse" : 10.0,
      "bg_color" : [ 0.4705880, 0.4705880, 0.4705880 ],
      "body" : [
         [ 0, 0, 0, 0, 0, 0, 0, 0 ],
         [ 0, 0, 0, 0, 0, 0, 0, 0 ],
         [ 0, 0, 0, -1, -1, 0, 0, 0 ],
         [ 0, 0, -1, -1, -1, -1, 0, 0 ],
         [ 0, 0, -1, -1, -1, -1, 0, 0 ],
         [ 0, 0, 0, 0, 0, 0, 0, 0 ],
         [ 0, 0, 0, 0, 0, 0, 0, 0 ],
         [ 0, 0, -1, -1, -1, -1, 0, 0 ],
         [ 0, 0, -1, -1, -1, -1, 0, 0 ],
         [ 0, 0, 0, 0, 0, 0, 0, 0 ],
         [ 0, 0, 0, 0, 0, 0, 0, 0 ],
         [ 0, 0, 0, 0, 0, 0, 0, 0 ],
         [ 0, 0, 0, 0, 0, 0, 0, 0 ],
         [ 0, 0, 0, 0, 0, 0, 0, 0 ],
         [ 0, 0, 0, 0, 0, 0, 0, 0 ],
         [ -1, -1, -1, 0, 0, -1, -1, -1 ],
         [ -1, -1, -1, 0, 0, -1, -1, -1 ],
         [ 0, 0, 0, 0, 0, 0, 0, 0 ],
         [ 0, 0, 0, 0, 0, 0, 0, 0 ],
         [ 0, 0, 0, 0, 0, 0, 0, 0 ]
      ],
      "build_speed" : 0.8000000119209290,
      "collapse_speed" : 0.8000000119209290,
      "color" : [ 0.5843140, 0.3372550, 0.1607840 ],
      "light_tween" : "default",
      "pickable" : 0,
      "x_offset" : 0
   }
}
