{
   "auto_collapse" : 5.0,
   "bg_color" : [ 0.4705880, 0.4705880, 0.4705880 ],
   "body" : [
      [ -1, -1, -1, -1, -1, -1, -1, -1, 0, 0, 0, 0 ],
      [ -1, -1, -1, -1, -1, -1, -1, -1, 0, 0, 0, 0 ],
      [ -1, -1, -1, -1, -1, -1, -1, -1, 0, 0, 0, 0 ],
      [ -1, -1, -1, -1, -1, -1, -1, -1, 0, 0, 0, 0 ],
      [ -1, -1, -1, -1, 0, 0, 0, 0, 0, 0, 0, 0 ],
      [ -1, -1, -1, -1, 0, 0, 0, 0, 0, 0, 0, 0 ],
      [ -1, -1, -1, -1, 0, 0, 0, 0, 0, 0, 0, 0 ],
      [ -1, -1, -1, -1, 0, 0, 0, 0, 0, 0, 0, 0 ],
      [ -1, -1, -1, -1, 0, 0, 0, -1, -1, -1, -1, -1 ],
      [ -1, -1, -1, -1, 0, 0, 0, -1, -1, -1, -1, -1 ],
      [ -1, -1, -1, -1, 0, 0, 0, -1, -1, -1, -1, -1 ],
      [ -1, -1, -1, -1, 0, 0, 0, -1, -1, -1, -1, -1 ],
      [ -1, -1, -1, -1, 0, 0, 0, -1, -1, -1, -1, -1 ],
      [ -1, -1, -1, -1, 0, 0, 0, -1, -1, -1, -1, -1 ],
      [ 0, 0, 0, 0, 0, 0, 0, -1, -1, -1, -1, -1 ],
      [ 0, 0, 0, 0, 0, 0, 0, -1, -1, -1, -1, -1 ],
      [ 0, 0, 0, 0, 0, 0, 0, -1, -1, -1, -1, -1 ],
      [ 0, 0, -1, -1, -1, -1, -1, -1, -1, -1, -1, -1 ],
      [ 0, 0, -1, -1, -1, -1, -1, -1, -1, -1, -1, -1 ],
      [ 0, 0, -1, -1, -1, -1, -1, -1, -1, -1, -1, -1 ],
      [ 0, 0, -1, -1, -1, -1, -1, -1, -1, -1, -1, -1 ],
      [ 0, 0, -1, -1, -1, -1, -1, -1, -1, -1, -1, -1 ],
      [ 0, 0, -1, -1, -1, -1, -1, -1, -1, -1, -1, -1 ],
      [ 0, 0, -1, -1, -1, -1, -1, -1, -1, -1, -1, -1 ],
      [ 0, 0, -1, -1, -1, -1, -1, -1, -1, -1, -1, -1 ],
      [ 0, 0, -1, -1, -1, -1, -1, -1, -1, -1, -1, -1 ],
      [ 0, 0, -1, -1, -1, -1, -1, -1, -1, -1, -1, -1 ],
      [ 0, 0, 0, 0, 0, 0, 0, 0, -1, -1, -1, -1 ],
      [ 0, 0, -1, -1, -1, -1, -1, 0, -1, -1, -1, -1 ],
      [ 0, 0, -1, -1, -1, -1, -1, 0, -1, -1, -1, -1 ],
      [ 0, 0, -1, -1, -1, -1, -1, 0, -1, -1, -1, -1 ],
      [ 0, 0, -1, -1, -1, -1, -1, 0, -1, -1, -1, -1 ],
      [ 0, 0, 0, 0, 0, 0, 0, 0, 0, 0, 0, 0 ],
      [ 0, 0, 0, 0, 0, 0, 0, 0, 0, 0, 0, 0 ],
      [ -1, -1, -1, -1, -1, -1, -1, -1, -1, -1, 0, 0 ]
   ],
   "build_speed" : 0.50,
   "collapse_speed" : 0.50,
   "color" : [ 0.4549020, 0.2705880, 0.6666670 ],
   "items" : [
      [ 9, 0, 3 ],
      [ 10, 0, 3 ],
      [ 4, 0, 11 ],
      [ 6, 0, 11 ],
      [ 0, 0, 17 ],
      [ 1, 0, 17 ],
      [ 7, 0, 27 ],
      [ 1, 0, 32 ]
   ],
   "light_tween" : "default",
   "moving" : [
      {
         "entry" : [ 5, 0, 8 ],
         "pattern" : [ 0, 4, 0, 6, 0, 6, 0, 4 ]
      },
      {
         "entry" : [ 2, 0, 15 ],
         "pattern" : [ 0, 2, 0, 8, 0, 8, 0, 2 ]
      },
      {
         "entry" : [ 1, 0, 23 ],
         "pattern" : [ 0, 6, 0, 4 ]
      },
      {
         "entry" : [ 0, 0, 30 ],
         "pattern" : [ 0, 4, 0, 6 ]
      },
      {
         "entry" : [ 10, 0, 32 ],
         "pattern" : [ 0, 8, 0, 4, 0, 2, 0, 6 ]
      }
   ],
   "pickable" : 0,
   "x_offset" : -4
}
