{
   "auto_collapse" : 10.0,
   "bg_color" : [ 0.4705880, 0.4705880, 0.4705880 ],
   "body" : [
      [ 0, 0, 0, 0, 0, 0, 0, 0 ],
      [ 0, 0, 0, 0, 0, 0, 0, 0 ],
      [ 0, 0, 0, 0, 0, 0, 0, 0 ],
      [ 0, 0, 0, 0, 0, 0, 0, 0 ],
      [ 0, 0, 0, 0, 0, 0, 0, 0 ],
      [ 0, 0, 0, 0, 0, 0, 0, 0 ],
      [ 0, 0, 0, 0, 0, 0, 0, 0 ],
      [ 0, 0, 0, 0, 0, 0, 0, 0 ],
      [ 0, 0, 0, 0, 0, 0, 0, 0 ],
      [ 0, 0, 0, 0, 0, 0, 0, 0 ],
      [ 0, 0, 0, -1, -1, 0, 0, 0 ],
      [ 0, 0, 0, -1, -1, 0, 0, 0 ],
      [ 0, 0, 0, -1, -1, 0, 0, 0 ],
      [ 0, 0, 0, -1, -1, 0, 0, 0 ],
      [ 0, 0, 0, -1, -1, 0, 0, 0 ],
      [ 0, 0, 0, -1, -1, 0, 0, 0 ],
      [ 0, 0, 0, -1, -1, 0, 0, 0 ],
      [ 0, 0, 0, -1, -1, 0, 0, 0 ],
      [ 0, 0, 0, -1, -1, 0, 0, 0 ],
      [ 0, 0, 0, -1, -1, 0, 0, 0 ],
      [ 0, 0, 0, 0, 0, 0, 0, 0 ],
      [ 0, 0, 0, 0, 0, 0, 0, 0 ],
      [ 0, 0, 0, 0, 0, 0, 0, 0 ],
      [ 0, 0, 0, 0, 0, 0, 0, 0 ],
      [ 0, 0, 0, 0, 0, 0, 0, 0 ]
   ],
   "build_speed" : 1.100000023841858,
   "collapse_speed" : 1.200000047683716,
   "color" : [ 0.4313730, 0.725490, 0.9294120 ],
   "items" : [
      [ 3, 0, 4 ],
      [ 6, 0, 8 ],
      [ 1, 0, 18 ],
      [ 4, 0, 23 ]
   ],
   "light_tween" : "default",
   "moving" : [
      {
         "entry" : [ 1, 0, 13 ],
         "pattern" : [ 4, 0, 6, 0, 6, 0, 4, 0 ]
      },
      {
         "entry" : [ 3, 0, 22 ],
         "pattern" : [ 4, 4, 4, 4, 6, 6, 6, 6, 6, 6, 6, 4, 4, 4 ]
      }
   ],
   "pickable" : 1,
   "x_offset" : 0
}
