{
   "auto_collapse" : 5.0,
   "bg_color" : [ 0.4705880, 0.4705880, 0.4705880 ],
   "body" : [
      [ 0, 0, 0, 0, -1, -1, -1, -1 ],
      [ 0, 0, 0, 0, -1, -1, -1, -1 ],
      [ 0, 0, 0, 0, -1, -1, -1, -1 ],
      [ 0, 0, 0, 0, -1, -1, -1, -1 ],
      [ 0, 0, 0, 0, -1, -1, -1, -1 ],
      [ 0, 0, 0, 0, 0, 0, 0, 0 ],
      [ 0, 0, 0, 0, 0, 0, 0, 0 ],
      [ 0, 0, 0, 0, 0, 0, 0, 0 ],
      [ -1, -1, -1, -1, -1, 0, 0, 0 ],
      [ -1, -1, -1, -1, -1, 0, 0, 0 ],
      [ -1, -1, -1, -1, -1, 0, 0, 0 ],
      [ -1, -1, -1, -1, -1, 0, 0, 0 ],
      [ 0, 0, 0, 0, 0, 0, 0, 0 ],
      [ 0, 0, 0, 0, 0, 0, 0, 0 ],
      [ 0, 0, 0, 0, 0, 0, 0, 0 ],
      [ 0, 0, -1, -1, -1, -1, -1, -1 ],
      [ 0, 0, -1, -1, -1, -1, -1, -1 ],
      [ 0, 0, -1, -1, -1, -1, -1, -1 ],
      [ 0, 0, -1, -1, -1, -1, -1, -1 ],
      [ 0, 0, -1, -1, -1, -1, -1, -1 ],
      [ 0, 0, -1, -1, -1, -1, -1, -1 ],
      [ 0, 0, 0, 0, 0, 0, 0, 0 ],
      [ 0, 0, 0, 0, 0, 0, 0, 0 ],
      [ -1, -1, -1, -1, -1, 0, 0, 0 ],
      [ -1, -1, -1, -1, -1, 0, 0, 0 ]
   ],
   "build_speed" : 0.50,
   "collapse_speed" : 0.50,
   "color" : [ 0, 0.60, 0.2666670 ],
   "items" : [
      [ 2, 0, 7 ],
      [ 5, 0, 7 ],
      [ 2, 0, 14 ],
      [ 5, 0, 14 ],
      [ 2, 0, 22 ],
      [ 5, 0, 22 ]
   ],
   "light_tween" : "default",
   "moving" : [
      {
         "entry" : [ 2, 0, 2 ],
         "pattern" : [ 6, 0, 6, 0, 4, 0, 4, 0, 4, 0 ]
      },
      {
         "entry" : [ 6, 0, 9 ],
         "pattern" : [ 4, 0, 6, 0, 6, 0, 4, 0 ]
      },
      {
         "entry" : [ 1, 0, 17 ],
         "pattern" : [ 6, 0, 4, 0 ]
      },
      {
         "entry" : [ 6, 0, 23 ],
         "pattern" : [ 6, 0, 4, 0 ]
      }
   ],
   "pickable" : 1,
   "x_offset" : 0
}
