{
   "auto_collapse" : 4.0,
   "bg_color" : [ 0.4705880, 0.4705880, 0.4705880 ],
   "body" : [
      [ -1, 0, 0, 0, -1, -1, 0, 0, 0, -1 ],
      [ -1, 0, 0, 0, -1, -1, 0, 0, 0, -1 ],
      [ 0, 0, 0, 0, -1, -1, 0, 0, 0, 0 ],
      [ 0, 0, 0, 0, -1, -1, 0, 0, 0, 0 ],
      [ 0, 0, 0, 0, -1, -1, 0, 0, 0, 0 ],
      [ 0, 0, 0, -1, -1, -1, -1, 0, 0, 0 ],
      [ 0, 0, 0, -1, -1, -1, -1, 0, 0, 0 ],
      [ 0, 0, 0, -1, -1, -1, -1, 0, 0, 0 ],
      [ 0, 0, 0, -1, -1, -1, -1, 0, 0, 0 ],
      [ 0, 0, 0, -1, -1, -1, -1, 0, 0, 0 ],
      [ 0, 0, 0, 0, 0, 0, 0, 0, 0, 0 ],
      [ 0, 0, 0, 0, 0, 0, 0, 0, 0, 0 ],
      [ 0, 0, 0, 0, 0, 0, 0, 0, 0, 0 ],
      [ 0, 0, 0, 0, 0, 0, 0, 0, 0, 0 ],
      [ -1, -1, 0, 0, 0, 0, 0, 0, -1, -1 ],
      [ -1, -1, 0, 0, 0, 0, 0, 0, -1, -1 ],
      [ -1, -1, 0, 0, 0, 0, 0, 0, -1, -1 ],
      [ -1, -1, 0, 0, 0, 0, 0, 0, -1, -1 ],
      [ -1, -1, 0, 0, 0, 0, 0, 0, -1, -1 ],
      [ 0, 0, 0, 0, -1, -1, 0, 0, 0, 0 ],
      [ 0, 0, 0, 0, -1, -1, 0, 0, 0, 0 ],
      [ 0, 0, 0, -1, -1, -1, -1, 0, 0, 0 ],
      [ 0, 0, 0, -1, -1, -1, -1, 0, 0, 0 ],
      [ 0, 0, 0, -1, -1, -1, -1, 0, 0, 0 ],
      [ 0, 0, 0, 0, 0, 0, 0, 0, 0, 0 ],
      [ 0, 0, 0, 0, 0, 0, 0, 0, 0, 0 ],
      [ -1, -1, -1, 0, 0, 0, 0, -1, -1, -1 ],
      [ -1, -1, -1, 0, 0, 0, 0, -1, -1, -1 ],
      [ -1, -1, -1, 0, 0, 0, 0, -1, -1, -1 ],
      [ -1, -1, -1, 0, 0, 0, 0, -1, -1, -1 ]
   ],
   "build_speed" : 0.5500000119209290,
   "collapse_speed" : 0.50,
   "color" : [ 0.5843140, 0.3372550, 0.1607840 ],
   "falling" : [
      {
         "delay" : 0.20,
         "entry" : [ 3, 0, 28 ],
         "interval" : 0.40
      },
      {
         "delay" : 0.20,
         "entry" : [ 4, 0, 28 ],
         "interval" : 0.40
      },
      {
         "delay" : 0.20,
         "entry" : [ 5, 0, 28 ],
         "interval" : 0.40
      },
      {
         "delay" : 0.20,
         "entry" : [ 6, 0, 28 ],
         "interval" : 0.40
      }
   ],
   "items" : [
      [ 1, 0, 13 ],
      [ 8, 0, 13 ],
      [ 1, 0, 25 ],
      [ 8, 0, 25 ]
   ],
   "light_tween" : "default",
   "pickable" : 0,
   "x_offset" : -1
}
