{
   "stage" : {
      "auto_collapse" : 10.0,
      "bg_color" : [ 0.70, 0.70, 0.70 ],
      "body" : [
         [ 0, 0, 0, 0, 0, 0, 0, 0 ],
         [ 0, 0, 0, 0, 0, 0, 0, 0 ],
         [ 0, 0, 0, -1, -1, 0, 0, 0 ],
         [ 0, 0, 0, -1, -1, 0, 0, 0 ],
         [ 0, 0, 0, 0, 0, 0, 0, 0 ],
         [ 0, 1, 1, 0, 0, 1, 1, 0 ],
         [ 0, 1, 1, 0, 0, 1, 1, 0 ],
         [ 0, 0, 0, 0, 0, 0, 0, 0 ],
         [ 0, 0, 0, 0, 0, 0, 0, 0 ],
         [ 0, 0, 0, 0, 0, 0, 0, 0 ],
         [ 0, 0, 0, 0, 0, 0, 0, 0 ],
         [ 0, 0, 0, 0, 0, 0, 0, 0 ],
         [ 0, 0, 0, 0, 0, 0, 0, 0 ],
         [ 0, 0, 0, 0, 0, 0, 0, 0 ],
         [ 0, 0, 0, -1, -1, 0, 0, 0 ],
         [ 0, 0, 0, -1, -1, 0, 0, 0 ],
         [ 0, 0, 0, -1, -1, 0, 0, 0 ],
         [ 0, 0, 0, -1, -1, 0, 0, 0 ],
         [ 0, 0, 0, 0, 0, 0, 0, 0 ],
         [ 0, 0, 0, 0, 0, 0, 0, 0 ]
      ],
      "build_speed" : 0.8000000119209290,
      "collapse_speed" : 0.8000000119209290,
      "color" : [ 0.7450980, 0.8196080, 0.5921570 ],
      "pickable" : 1,
      "x_offset" : 0
   }
}
