{
   "stage" : {
      "auto_collapse" : 10.0,
      "bg_color" : [ 0.4705880, 0.4705880, 0.4705880 ],
      "body" : [
         [ 0, 0, 0, 0, 0, 0, 0, 0 ],
         [ 0, 0, 0, 0, 0, 0, 0, 0 ],
         [ 0, 0, 0, -1, -1, 0, 0, 0 ],
         [ 0, 0, 0, -1, -1, 0, 0, 0 ],
         [ 0, 0, 0, 0, 0, 0, 0, 0 ],
         [ 0, 0, 0, 0, 0, 0, 0, 0 ],
         [ 0, 1, 1, 0, 0, 1, 1, 0 ],
         [ 0, 1, 1, 0, 0, 1, 1, 0 ],
         [ 0, 0, 0, 0, 0, 0, 0, 0 ],
         [ 0, 0, 0, 0, 0, 0, 0, 0 ],
         [ -1, -1, 0, 0, 0, 0, -1, -1 ],
         [ -1, -1, 0, 0, 0, 0, -1, -1 ],
         [ 0, 0, 0, 0, 0, 0, 0, 0 ],
         [ 0, 0, 0, 0, 0, 0, 0, 0 ],
         [ 0, 0, 0, -1, -1, 0, 0, 0 ],
         [ 0, 0, 0, -1, -1, 0, 0, 0 ],
         [ 0, 0, 0, -1, -1, 0, 0, 0 ],
         [ 0, 0, 0, -1, -1, 0, 0, 0 ],
         [ 0, 0, 0, 0, 0, 0, 0, 0 ],
         [ 0, 0, 0, 0, 0, 0, 0, 0 ],
         [ 0, 0, 0, 0, 0, 0, 0, 0 ],
         [ 0, 0, 0, 0, 0, 0, 0, 0 ],
         [ -1, -1, -1, 0, 0, -1, -1, -1 ],
         [ -1, -1, -1, 0, 0, -1, -1, -1 ],
         [ 0, 0, 0, 0, 0, 0, 0, 0 ]
      ],
      "build_speed" : 0.8000000119209290,
      "collapse_speed" : 0.8000000119209290,
      "color" : [ 0, 0.60, 0.2666670 ],
      "items" : [
         [ 1, 0, 5 ],
         [ 6, 0, 5 ],
         [ 1, 0, 18 ],
         [ 6, 0, 18 ]
      ],
      "light_tween" : "default",
      "moving" : [
         {
            "entry" : [ 1, 0, 16 ],
            "pattern" : [ 6, 0, 4, 0, 4, 0, 6, 0 ]
         },
         {
            "entry" : [ 6, 0, 16 ],
            "pattern" : [ 4, 0, 6, 0, 6, 0, 4, 0 ]
         }
      ],
      "pickable" : 1,
      "x_offset" : 0
   }
}
