{
   "auto_collapse" : 5.0,
   "bg_color" : [ 0.4705880, 0.4705880, 0.4705880 ],
   "body" : [
      [ 0, 0, 0, 0, 0, 0, 0, 0 ],
      [ 0, 0, 0, 0, 0, 0, 0, 0 ],
      [ 0, 0, 0, 0, 0, 0, 0, 0 ],
      [ 0, 0, 0, 0, 0, 0, 0, 0 ],
      [ 0, 0, 0, 0, 0, 0, 0, 0 ],
      [ -1, -1, -1, 0, 0, 0, 0, 0 ],
      [ -1, -1, -1, 0, 0, 0, 0, 0 ],
      [ -1, -1, -1, 0, 0, 0, 0, 0 ],
      [ -1, -1, -1, 0, 0, 0, 0, 0 ],
      [ 0, 0, 0, 0, 0, 0, 0, 0 ],
      [ 0, 0, 0, 0, 0, 0, 0, 0 ],
      [ 0, 0, 0, 0, 0, 0, 0, 0 ],
      [ 0, 0, 0, 0, -1, -1, -1, -1 ],
      [ 0, 0, 0, 0, -1, -1, -1, -1 ],
      [ 0, 0, 0, 0, -1, -1, -1, -1 ],
      [ 0, 0, 0, 0, 0, 0, 0, 0 ],
      [ 0, 0, 0, 0, 0, 0, 0, 0 ],
      [ 0, 0, 0, 0, 0, 0, 0, 0 ],
      [ -1, -1, -1, 0, 0, 0, 0, 0 ],
      [ -1, -1, -1, 0, 0, 0, 0, 0 ],
      [ 0, 0, 0, 0, 0, 0, 0, 0 ],
      [ 0, 0, 0, 0, 0, 0, 0, 0 ],
      [ 0, 0, 0, -1, -1, -1, -1, -1 ],
      [ 0, 0, 0, -1, -1, -1, -1, -1 ],
      [ 0, 0, 0, -1, -1, -1, -1, -1 ]
   ],
   "build_speed" : 0.50,
   "collapse_speed" : 0.50,
   "color" : [ 0, 0.60, 0.2666670 ],
   "items" : [
      [ 3, 0, 5 ],
      [ 5, 0, 11 ],
      [ 1, 0, 17 ],
      [ 5, 0, 17 ],
      [ 5, 0, 21 ]
   ],
   "light_tween" : "default",
   "pickable" : 0,
   "x_offset" : 0
}
