{
   "auto_collapse" : 7.0,
   "bg_color" : [ 0.3137260, 0.3137260, 0.3137260 ],
   "body" : [
      [ 0, 0, 0, 0, 0, 0, 0, 0 ],
      [ 0, 0, 0, 0, 0, 0, 0, 0 ],
      [ -1, -1, 0, 0, 0, 0, -1, -1 ],
      [ -1, -1, 0, 0, 0, 0, -1, -1 ],
      [ -1, -1, -1, 0, 0, -1, -1, -1 ],
      [ -1, -1, -1, 0, 0, -1, -1, -1 ],
      [ -1, -1, -1, 0, 0, -1, -1, -1 ],
      [ -1, -1, -1, 0, 0, -1, -1, -1 ],
      [ 0, 0, 0, 0, 0, 0, 0, 0 ],
      [ 0, 0, 0, 0, 0, 0, 0, 0 ],
      [ 0, 0, 0, 0, 0, 0, 0, 0 ],
      [ 0, 0, 0, 0, 0, 0, 0, 0 ],
      [ 0, 0, 0, 0, 0, 0, 0, 0 ],
      [ 0, 0, 0, 0, 0, 0, 0, 0 ],
      [ -1, 0, 0, 0, 0, 0, 0, -1 ],
      [ -1, 0, 0, 0, 0, 0, 0, -1 ],
      [ -1, 0, -1, -1, -1, -1, 0, -1 ],
      [ -1, 0, -1, -1, -1, -1, 0, -1 ],
      [ 0, 0, -1, -1, -1, -1, 0, 0 ],
      [ 0, -1, -1, -1, -1, -1, -1, 0 ],
      [ 0, -1, -1, -1, -1, -1, -1, 0 ],
      [ 0, -1, -1, 0, 0, -1, -1, 0 ],
      [ 0, 0, 0, 0, 0, 0, 0, 0 ],
      [ 0, 0, 0, 0, 0, 0, 0, 0 ],
      [ 0, 0, 0, 0, 0, 0, 0, 0 ]
   ],
   "build_speed" : 0.50,
   "camera" : "normal",
   "collapse_speed" : 0.50,
   "color" : [ 0.4313730, 0.725490, 0.9294120 ],
   "items" : [
      [ 3, 0, 5 ],
      [ 3, 0, 8 ],
      [ 5, 0, 11 ],
      [ 5, 0, 14 ],
      [ 3, 0, 21 ],
      [ 4, 0, 21 ]
   ],
   "light_tween" : "default",
   "pickable" : 0,
   "x_offset" : 0
}
